#################################################
#         #              #                      #
#         #                                     #
#         #              #                      #
#####  ###################                      #
#                #                              #
#                #                              #
#                                               #
#                #                              #
#                # ####################  ########
#                #               #              #
########  ########               #              #
#                                #              #
#                                #              #
#                                               #
#                                #              #
#                                #              #
#                                #              #
#################################################